C 51, 159,		255
NO ./sprites/bluebrick.xpm
SO ./sprites/brickwall.xpm
F 81,90,90
WE ./sprites/greybrick.xpm
EA ./sprites/brownbrick.xpm

11111111111111111111111111111111
10000000000000000000000000000001
10000000000001110000000000000001
10000000000011110000000000000001
10000000001111110001111100000001
10000000001111100001111110000001
10000000011111000001111111000001
10000000111110000000001111100001
10000001111100000000000111100001
10000011111000000E00000011100001
10011110000000000000000001110001
10011110000000011110000001110001
10011100000000111110000001110001
10011111000001111110000001110001
10011111111111111111000001110001
10011111111111111111000001110001
10000011111111111111000011110001
10000000001111100000000011110001
10000000011111000000000111110001
10000000111110000000001111100001
10000111100000001111110000000001
10000111100000001111110000000001
10000111000000000111100000000001
10000111000000000011111000000001
10000000000000000000111111000001
10000000000000000000011111111001
10000000000000000000000000000001
11111111111111111111111111111111
