NO ./path_to_the_north_texture
SO ./path_to_the_south_texturerefer
WE ./path_to_the_west_texture
EA ./path_to_the_east_texture

F 220,100,150                   
C 225,30,0

        1111111111111111111111111
        1000000000110000000000001
        1011000001110000000000001
        1001000000000000000000001
111111111011000001110000000000001
100000000011000001110111111111111
1111011111 111101110000010001
1111011 111111101110101000001
11000001110101011100000010001
1000000100000E001100000010001
1000001 100000001101010010001
11000001010101011111011110001
1111011111110101 101111010001
11111111 1111111 111111111111
