C 203,235,196
NO ./sprites/bluebrick.xpm
SO ./sprites/brickwall.xpm
F 18,45,19
WE ./sprites/greybrick.xpm
EA ./sprites/brownbrick.xpm


        1111111111111111111111111
        1000000000110000000000001
        1011000001110000000000001
        1001000000000000000000001
111111111011000001110000000000001
100000000011000001110111111111011
1111011111 1111011100000100010001
1111011 1111111011101010000010001
110000011101010001000000100010001
100000000000000100000000100010001
10000011100000001100010010N010001
110000010101010111110111000010001
1111011111110101 1011110100010001
11111111 1111111 1111111111111111
